1111111111111
1001000P00001
100101100C001
10E0011E11111
1111111111111