1111111111111
1001000000001
1000C11111001
1000PE1000001
1111111111111